NO ./textures/north.xpm
SO ./textures/south.xpm
WE ./textures/west.xpm
EA ./textures/east.xpm
F 220,100,0
C 225,30,0

111111111
100000001
100010001
101000001
1000N0001
100001101
100100001
100001001
111111111